Gracz,Gra 1,Gra 2,Gra 3,Gra 4,Gra 5,Gra 6,Gra 7,Suma
Kubson,7,7,8,-1,4,4,4,33
boomer,0,6,3,6,4,6,7,32
Kostek,0,4,2,8,2,4,5,25
Slowianka,0,6,0,0,5,8,3,22
andrzeJJ,8,6,8,0,0,0,0,22
NeJJmak,0,2,0,0,6,7,6,21
Monia,0,0,0,-2,7,7,6,18
SzymixJP,0,4,1,0,4,4,4,17
Dawid,0,5,1,-1,4,3,3,15
BlackRose,1,4,4,-1,4,1,1,14
Jakub,0,2,0,0,3,4,4,13
