Gracz,Gra 1,Gra 2,Gra 3,Gra 4,Gra 5,Suma
Cortez,4,5,4,7,8,28
Drucker,6,6,2,9,1,24
Jakub,4,4,8,0,8,24
Michal,8,2,5,0,8,23
Slowianka,4,8,4,-1,8,23
Neimak,4,6,4,0,8,22
andrzej,1,6,8,0,7,22
SzymixJP,4,7,4,0,4,19
LanaBanana,4,6,8,0,0,18
Dhar,0,1,4,0,4,9
