Gracz,Gra 1,Gra 2,Gra 3,Gra 4,Gra 5,Gra 6,Gra 7,Gra 8,Suma
Kubson,7,7,8,-1,4,4,4,4,37
boomer,0,6,3,6,4,6,7,4,36
Kostek,0,4,2,8,2,4,5,3,28
Slowianka,0,6,0,0,5,8,3,3,25
NeJJmak,0,2,0,0,6,7,6,2,23
Monia,0,0,0,-2,7,7,6,4,22
andrzeJJ,8,6,8,0,0,0,0,0,22
Dawid,0,5,1,-1,4,3,3,6,21
SzymixJP,0,4,1,0,4,4,4,4,21
Jakub,0,2,0,0,3,4,4,5,18
BlackRose,1,4,4,-1,4,1,1,1,15
