Gracz,Gra 1,Gra 2,Gra 3,Gra 4,Suma
Drucker,6,6,2,9,23
Cortez,4,5,4,7,20
LanaBanana,4,6,8,0,18
Jakub,4,4,8,0,16
Michal,8,2,5,0,15
Slowianka,4,8,4,-1,15
SzymixJP,4,7,4,0,15
andrzej,1,6,8,0,15
Neimak,4,6,4,0,14
Dhar,0,1,4,0,5
