Gracz,Gra 1,Gra 2,Gra 3,Gra 4,Gra 5,Suma
Drucker,6,6,2,9,7,30
LanaBanana,4,6,8,0,6,24
SzymixJP,4,7,4,0,9,24
Jakub,4,4,8,0,6,22
Neimak,4,6,4,0,8,22
Cortez,4,5,4,7,0,20
Michal,8,2,5,0,4,19
Slowianka,4,8,4,-1,0,15
andrzej,1,6,8,0,0,15
Dhar,0,1,4,0,0,5
