Gracz,Gra 1,Gra 2,Gra 3,Gra 4,Gra 5,Gra 6,Suma
Cortez,4,5,4,7,8,3,31
Michal,8,2,5,0,8,8,31
Jakub,4,4,8,0,8,6,30
Drucker,6,6,2,9,1,4,28
Neimak,4,6,4,0,8,6,28
Slowianka,4,8,4,-1,8,3,26
andrzej,1,6,8,0,7,4,26
SzymixJP,4,7,4,0,4,4,23
LanaBanana,4,6,8,0,0,4,22
Dhar,0,1,4,0,4,0,9
