Gracz,Gra 1,Gra 2,Gra 3,Gra 4,Gra 5,Suma
Kubson,7,7,8,-1,4,25
andrzeJJ,8,6,8,0,0,22
boomer,0,6,3,6,4,19
Kostek,0,4,2,8,2,16
BlackRose,1,4,4,-1,4,12
Slowianka,0,6,0,0,5,11
Dawid,0,5,1,-1,4,9
SzymixJP,0,4,1,0,4,9
NeJJmak,0,2,0,0,6,8
Jakub,0,2,0,0,3,5
Monia,0,0,0,-2,7,5
