Gracz,Gra 1,Gra 2,Gra 3,Gra 4,Gra 5,Gra 6,Gra 7,Gra 8,Suma
boomer,5,6,6,6,7,3,1,5,39
NeJJmak,4,6,6,5,5,6,0,6,38
Jakub,6,4,3,6,1,6,6,3,35
Zelka,4,1,7,4,6,6,-1,5,32
Monika,1,6,1,8,4,6,0,5,31
Kubson,1,4,5,2,2,5,7,2,28
Cortez,4,2,4,4,4,1,1,6,26
Slowianka,4,0,5,4,4,4,1,4,26
WildBoy,0,4,4,1,0,3,0,2,14
andrzej,0,4,8,2,0,0,0,0,14
lascik,0,0,0,0,8,0,0,0,8
Szoszonix,0,0,0,0,0,0,0,6,6
jakubson,4,0,0,0,0,0,0,0,4
Szsz,0,0,0,0,0,0,1,0,1
