Gracz,Gra 1,Gra 2,Gra 3,Gra 4,Gra 5,Gra 6,Gra 7,Suma
boomer,5,6,6,6,7,3,1,34
Jakub,6,4,3,6,1,6,6,32
NeJJmak,4,6,6,5,5,6,0,32
Zelka,4,1,7,4,6,6,-1,27
Kubson,1,4,5,2,2,5,7,26
Monika,1,6,1,8,4,6,0,26
Slowianka,4,0,5,4,4,4,1,22
Cortez,4,2,4,4,4,1,1,20
andrzej,0,4,8,2,0,0,0,14
WildBoy,0,4,4,1,0,3,0,12
lascik,0,0,0,0,8,0,0,8
jakubson,4,0,0,0,0,0,0,4
Szsz,0,0,0,0,0,0,1,1
