Gracz,Gra 1,Gra 2,Gra 3,Gra 4,Gra 5,Gra 6,Suma
Kubson,7,7,8,-1,4,4,29
boomer,0,6,3,6,4,6,25
andrzeJJ,8,6,8,0,0,0,22
Kostek,0,4,2,8,2,4,20
Slowianka,0,6,0,0,5,8,19
NeJJmak,0,2,0,0,6,7,15
BlackRose,1,4,4,-1,4,1,13
SzymixJP,0,4,1,0,4,4,13
Dawid,0,5,1,-1,4,3,12
Monia,0,0,0,-2,7,7,12
Jakub,0,2,0,0,3,4,9
