Gracz,Gra 1,Gra 2,Gra 3,Gra 4,Gra 5,Suma
Drucker,6,6,2,9,4,27
Cortez,4,5,4,7,4,24
LanaBanana,4,6,8,0,4,22
Jakub,4,4,8,0,4,20
SzymixJP,4,7,4,0,4,19
andrzej,1,6,8,0,4,19
Neimak,4,6,4,0,4,18
Slowianka,4,8,4,-1,2,17
Michal,8,2,5,0,1,16
Dhar,0,1,4,0,4,9
